ss#############################
ss....#.......#.#.#.#.#.......#
#####.#######.#.#.#.#.#.#.#.#.#
#.......#.#.....#.#.....#.#.#.#
#.###.###.#####.#.#.#######.#.#
#...#.........#.........#...#.#
#.###.###.#.###########.###.#.#
#.#.....#.#...#.......#...#.#.#
#.#########.#####.###.#.#####.#
#.....#.#...#...#...#...#.#.#.#
###.###.#.###.#####.###.#.#.#.#
#.#.....#.#.#.#.#.....#...#...#
#.#####.###.#.#.#.#######.#####
#...#.....#.#.....#.....#.#...#
###.#####.#.#.###.#.###.#.###.#
#...#.#.#.......#...#...#.....#
#.###.#.#####.###.#######.#####
#...#.....#...#...#.....#.#.#.#
#.#.#.#########.#####.#.#.#.#.#
#.#.#.#...#.....#.....#.#.....#
#.###.###.#######.###.#######.#
#.....#.....#.#.#.#.....#.....#
#.###.###.#.#.#.#.###.###.#.###
#...#.#...#.......#.#.....#.#.#
#.#.###.###.#######.###.#####.#
#.#.....#...#...#.#...#...#...#
#.###########.###.###.###.###.#
#.#...........#.#.........#.#.#
#######.#.###.#.#.#######.#.#.#
#.......#...#.....#..........cc
#############################cc
