ss#############################
ss..#.....#...............#.#.#
#.#.#####.#########.#.#####.#.#
#.#.....#.....#...#.#.....#.#.#
#######.#.#.#####.#####.#.#.#.#
#...#.....#.......#.#...#.....#
###.#########.#####.#####.#.#.#
#...#.#.#.#.....#.....#...#.#.#
#.#.#.#.#.###.#.###.###.#.###.#
#.#.#.....#.#.#.........#.#...#
#.###.###.#.###.#######.###.#.#
#.....#.....#.....#...#.#...#.#
#.###.#######.###.#.#.#.#######
#...#.......#.#.#.#.#.........#
#.#####.#######.#.#####.#.###.#
#.....#...#.#...#.#.#.#.#.#.#.#
#.###.#.###.#.###.#.#.#####.###
#...#.#...#.#.........#.....#.#
#.#######.#.###.#.#.#######.#.#
#...#...........#.#.#...#.....#
#.#####.#.###.#.#####.###.#####
#...#...#.#.#.#...#...#.#.....#
###.#####.#.#.#.#.#.###.#.#.###
#.#.#...#.#...#.#.#.......#...#
#.#.#.###.###########.###.#.###
#.....#...#.#.......#...#.#...#
###.#######.#.###.###########.#
#.......#.#...#...#.#.....#...#
#.#.###.#.###.#.#.#.#.#.###.###
#.#...#.......#.#.....#......cc
#############################cc
