ss#############################
ss..#.....#...#.....#.....#...#
#.###.#####.#######.###.###.#.#
#.....#.#...........#.#.#...#.#
#.#####.#####.#####.#.#.#.###.#
#.......#.#.#...#.....#.#.#...#
#.#####.#.#.###.#####.#.#.###.#
#.#.#...#.......#...........#.#
#.#.###.#####.###.###.#######.#
#.....#...#...#...#.#...#...#.#
###.###.#.#########.#.#.###.###
#.#.#...#.#.....#.....#.#...#.#
#.#.###.#.###.#########.#.###.#
#.#...#.#...#...#.#...........#
#.#.#.#.#.#.###.#.#######.###.#
#...#.#.#.#.#.#...#...#.#...#.#
#.#######.###.#.###.#.#.#.#####
#.....#.#.......#.#.#.........#
#######.###.#.###.#.#####.###.#
#...#.....#.#.#.......#.#.#.#.#
#.#.#####.#.###########.###.#.#
#.#.#.....#.#...#...#.#.....#.#
###.#####.#.#.#.###.#.#.###.#.#
#.#.#...#.....#.....#.....#...#
#.#.###.###########.#.###.#.#.#
#.......#...#...........#.#.#.#
#.#######.#########.#########.#
#.#.....#.#.#...#.........#...#
#.###.###.#.#.#####.#.#######.#
#...................#...#....cc
#############################cc